1.700000000000000122e-01 3.250000000000000000e+00 3.539999999999988489e+00 9.866860052374253343e-01
1.700000000000000122e-01 3.250000000000000000e+00 3.589999999999987423e+00 9.858763281223261732e-01
1.700000000000000122e-01 3.250000000000000000e+00 5.279999999999951399e+00 9.993885463803661162e-01
1.700000000000000122e-01 3.250000000000000000e+00 4.919999999999959073e+00 9.986585628412436577e-01
1.700000000000000122e-01 3.250000000000000000e+00 3.289999999999993818e+00 9.990004084956957131e-01
1.700000000000000122e-01 3.250000000000000000e+00 4.469999999999968665e+00 9.963373810445390610e-01
1.700000000000000122e-01 3.250000000000000000e+00 5.139999999999954383e+00 9.991727961856657902e-01
1.700000000000000122e-01 3.250000000000000000e+00 5.639999999999943725e+00 9.997123791270752236e-01
1.700000000000000122e-01 3.250000000000000000e+00 3.519999999999988916e+00 9.871812369100176898e-01
1.700000000000000122e-01 3.250000000000000000e+00 5.059999999999956088e+00 9.990148991978388127e-01
1.700000000000000122e-01 3.250000000000000000e+00 3.689999999999985292e+00 9.857112052484434672e-01
1.700000000000000122e-01 3.250000000000000000e+00 4.079999999999976978e+00 9.916473249141264379e-01
1.700000000000000122e-01 3.250000000000000000e+00 3.999999999999978684e+00 9.903062690720126904e-01
1.700000000000000122e-01 3.250000000000000000e+00 3.769999999999983586e+00 9.864928244123678525e-01
1.700000000000000122e-01 3.250000000000000000e+00 3.839999999999982094e+00 9.875328958655686939e-01
1.700000000000000122e-01 3.250000000000000000e+00 3.739999999999984226e+00 9.861336272560290439e-01
1.700000000000000122e-01 3.250000000000000000e+00 4.149999999999975486e+00 9.927272787669262355e-01
1.700000000000000122e-01 3.250000000000000000e+00 3.819999999999982521e+00 9.872138311291290824e-01
1.700000000000000122e-01 3.250000000000000000e+00 3.959999999999979536e+00 9.896071885611783525e-01
1.700000000000000122e-01 3.250000000000000000e+00 4.369999999999970797e+00 9.954347074419710450e-01
1.700000000000000122e-01 3.250000000000000000e+00 3.549999999999988276e+00 9.864767535098407647e-01
1.700000000000000122e-01 3.250000000000000000e+00 3.329999999999992966e+00 9.968189864494925168e-01
1.700000000000000122e-01 3.250000000000000000e+00 4.189999999999974634e+00 9.932981744222414422e-01
1.700000000000000122e-01 3.250000000000000000e+00 4.619999999999965468e+00 9.973788630396295263e-01
1.700000000000000122e-01 3.250000000000000000e+00 5.899999999999938183e+00 9.998294938585212677e-01
1.700000000000000122e-01 3.250000000000000000e+00 3.359999999999992326e+00 9.949221293193206694e-01
1.700000000000000122e-01 3.250000000000000000e+00 4.449999999999969091e+00 9.961714495623232857e-01
1.700000000000000122e-01 3.250000000000000000e+00 4.349999999999971223e+00 9.952311961823684383e-01
1.700000000000000122e-01 3.250000000000000000e+00 4.209999999999974207e+00 9.935704444245186950e-01
1.700000000000000122e-01 3.250000000000000000e+00 4.489999999999968239e+00 9.964964564823678428e-01
1.700000000000000122e-01 3.250000000000000000e+00 3.989999999999978897e+00 9.901326969694660418e-01
1.700000000000000122e-01 3.250000000000000000e+00 3.000000000000000000e+00 7.790471234674911649e-01
1.700000000000000122e-01 3.250000000000000000e+00 3.509999999999989129e+00 9.874686236594272248e-01
1.700000000000000122e-01 3.250000000000000000e+00 5.769999999999940954e+00 9.997790607499729143e-01
1.700000000000000122e-01 3.250000000000000000e+00 5.379999999999949267e+00 9.995058094758375589e-01
1.700000000000000122e-01 3.250000000000000000e+00 3.899999999999980815e+00 9.885512260529496498e-01
1.700000000000000122e-01 3.250000000000000000e+00 4.639999999999965041e+00 9.974936310047490817e-01
1.700000000000000122e-01 3.250000000000000000e+00 3.419999999999991047e+00 9.913030105208398002e-01
1.700000000000000122e-01 3.250000000000000000e+00 3.479999999999989768e+00 9.884963164721054518e-01
1.700000000000000122e-01 3.250000000000000000e+00 5.849999999999939249e+00 9.998117289061421165e-01
1.700000000000000122e-01 3.250000000000000000e+00 3.059999999999998721e+00 9.110485722988646007e-01
1.700000000000000122e-01 3.250000000000000000e+00 4.029999999999978044e+00 9.908201847489468417e-01
1.700000000000000122e-01 3.250000000000000000e+00 3.869999999999981455e+00 9.880333451754879093e-01
1.700000000000000122e-01 3.250000000000000000e+00 4.389999999999970370e+00 9.956302808915250546e-01
1.700000000000000122e-01 3.250000000000000000e+00 5.649999999999943512e+00 9.997182021851235278e-01
1.700000000000000122e-01 3.250000000000000000e+00 5.179999999999953531e+00 9.992415824147693471e-01
1.700000000000000122e-01 3.250000000000000000e+00 5.959999999999936904e+00 9.998484766344938324e-01
1.700000000000000122e-01 3.250000000000000000e+00 3.319999999999993179e+00 9.974220861118000547e-01
1.700000000000000122e-01 3.250000000000000000e+00 3.079999999999998295e+00 9.369367612874842655e-01
1.700000000000000122e-01 3.250000000000000000e+00 3.929999999999980176e+00 9.890781495168405879e-01
1.700000000000000122e-01 3.250000000000000000e+00 3.119999999999997442e+00 9.710757660708455585e-01
1.700000000000000122e-01 3.250000000000000000e+00 3.109999999999997655e+00 9.643570496107316536e-01
1.700000000000000122e-01 3.250000000000000000e+00 5.889999999999938396e+00 9.998260898361459592e-01
1.700000000000000122e-01 3.250000000000000000e+00 5.399999999999948841e+00 9.995262661950279348e-01
1.700000000000000122e-01 3.250000000000000000e+00 4.979999999999957794e+00 9.988253328531671027e-01
1.700000000000000122e-01 3.250000000000000000e+00 3.469999999999989981e+00 9.888951024673560131e-01
1.700000000000000122e-01 3.250000000000000000e+00 4.119999999999976126e+00 9.922765934956504497e-01
1.700000000000000122e-01 3.250000000000000000e+00 5.329999999999950333e+00 9.994504705731032113e-01
1.700000000000000122e-01 3.250000000000000000e+00 3.409999999999991260e+00 9.918614392081543940e-01
1.700000000000000122e-01 3.250000000000000000e+00 3.019999999999999574e+00 8.340233796102378694e-01
1.700000000000000122e-01 3.250000000000000000e+00 3.389999999999991687e+00 9.930414810175783868e-01
1.700000000000000122e-01 3.250000000000000000e+00 3.499999999999989342e+00 9.877833170989304135e-01
1.700000000000000122e-01 3.250000000000000000e+00 3.749999999999984013e+00 9.862458878658049155e-01
1.700000000000000122e-01 3.250000000000000000e+00 5.319999999999950546e+00 9.994386372598138557e-01
1.700000000000000122e-01 3.250000000000000000e+00 3.559999999999988063e+00 9.862920276633935224e-01
1.700000000000000122e-01 3.250000000000000000e+00 5.239999999999952252e+00 9.993337214772766153e-01
1.700000000000000122e-01 3.250000000000000000e+00 5.729999999999941807e+00 9.997605009776517893e-01
1.700000000000000122e-01 3.250000000000000000e+00 4.429999999999969518e+00 9.959984367655294601e-01
1.700000000000000122e-01 3.250000000000000000e+00 5.419999999999948415e+00 9.995458286620858557e-01
1.700000000000000122e-01 3.250000000000000000e+00 5.349999999999949907e+00 9.994733538953913810e-01
1.700000000000000122e-01 3.250000000000000000e+00 4.509999999999967812e+00 9.966489022598855607e-01
1.700000000000000122e-01 3.250000000000000000e+00 5.029999999999956728e+00 9.989478429893310363e-01
1.700000000000000122e-01 3.250000000000000000e+00 4.669999999999964402e+00 9.976564721519642909e-01
1.700000000000000122e-01 3.250000000000000000e+00 4.289999999999972502e+00 9.945711865379940342e-01
1.700000000000000122e-01 3.250000000000000000e+00 5.809999999999940101e+00 9.997960926540381266e-01
1.700000000000000122e-01 3.250000000000000000e+00 5.619999999999944151e+00 9.997003449720009982e-01
1.700000000000000122e-01 3.250000000000000000e+00 5.469999999999947349e+00 9.995910845988766891e-01
1.700000000000000122e-01 3.250000000000000000e+00 5.229999999999952465e+00 9.993192222458963103e-01
1.700000000000000122e-01 3.250000000000000000e+00 5.009999999999957154e+00 9.989005138270404816e-01
1.700000000000000122e-01 3.250000000000000000e+00 4.339999999999971436e+00 9.951264032685113170e-01
1.700000000000000122e-01 3.250000000000000000e+00 3.629999999999986571e+00 9.856108582248174210e-01
1.700000000000000122e-01 3.250000000000000000e+00 3.569999999999987850e+00 9.861309769483006527e-01
1.700000000000000122e-01 3.250000000000000000e+00 3.919999999999980389e+00 9.889019592747313459e-01
1.700000000000000122e-01 3.250000000000000000e+00 5.669999999999943086e+00 9.997294748044973645e-01
1.700000000000000122e-01 3.250000000000000000e+00 4.399999999999970157e+00 9.957251541549146934e-01
1.700000000000000122e-01 3.250000000000000000e+00 4.459999999999968878e+00 9.962552864308747980e-01
1.700000000000000122e-01 3.250000000000000000e+00 5.709999999999942233e+00 9.997506032791991792e-01
1.700000000000000122e-01 3.250000000000000000e+00 3.489999999999989555e+00 9.881257744113266517e-01
1.700000000000000122e-01 3.250000000000000000e+00 5.209999999999952891e+00 9.992892191370380539e-01
1.700000000000000122e-01 3.250000000000000000e+00 4.929999999999958860e+00 9.986879718640953030e-01
1.700000000000000122e-01 3.250000000000000000e+00 5.299999999999950973e+00 9.994141562847493887e-01
1.700000000000000122e-01 3.250000000000000000e+00 5.249999999999952038e+00 9.993478961049403475e-01
1.700000000000000122e-01 3.250000000000000000e+00 5.969999999999936691e+00 9.998514140787979620e-01
1.700000000000000122e-01 3.250000000000000000e+00 4.479999999999968452e+00 9.964177616301045370e-01
1.700000000000000122e-01 3.250000000000000000e+00 4.939999999999958646e+00 9.987167156187036765e-01
1.700000000000000122e-01 3.250000000000000000e+00 4.879999999999959925e+00 9.985339633871300746e-01
1.700000000000000122e-01 3.250000000000000000e+00 4.949999999999958433e+00 9.987448090819879276e-01
1.700000000000000122e-01 3.250000000000000000e+00 4.199999999999974420e+00 9.934354155342931536e-01
1.700000000000000122e-01 3.250000000000000000e+00 4.769999999999962270e+00 9.981264091280805939e-01
1.700000000000000122e-01 3.250000000000000000e+00 5.389999999999949054e+00 9.995161522330822113e-01
1.700000000000000122e-01 3.250000000000000000e+00 4.219999999999973994e+00 9.937032574925682704e-01
1.700000000000000122e-01 3.250000000000000000e+00 4.129999999999975913e+00 9.924289140548170352e-01
1.700000000000000122e-01 3.250000000000000000e+00 3.169999999999996376e+00 9.918985850947297234e-01
1.700000000000000122e-01 3.250000000000000000e+00 3.199999999999995737e+00 9.973544816974321270e-01
1.700000000000000122e-01 3.250000000000000000e+00 5.879999999999938609e+00 9.998226130000036349e-01
1.700000000000000122e-01 3.250000000000000000e+00 3.239999999999994884e+00 9.999164477297742826e-01
1.700000000000000122e-01 3.250000000000000000e+00 4.899999999999959499e+00 9.985976875002273712e-01
1.700000000000000122e-01 3.250000000000000000e+00 4.689999999999963975e+00 9.977591147920952253e-01
1.700000000000000122e-01 3.250000000000000000e+00 4.659999999999964615e+00 9.976033998364095545e-01
1.700000000000000122e-01 3.250000000000000000e+00 5.579999999999945004e+00 9.996746385844187399e-01
1.700000000000000122e-01 3.250000000000000000e+00 3.349999999999992539e+00 9.955608729411132840e-01
1.700000000000000122e-01 3.250000000000000000e+00 4.439999999999969305e+00 9.960858423248835081e-01
1.700000000000000122e-01 3.250000000000000000e+00 3.219999999999995310e+00 9.991540667271827658e-01
1.700000000000000122e-01 3.250000000000000000e+00 3.339999999999992752e+00 9.961956629505668293e-01
1.700000000000000122e-01 3.250000000000000000e+00 3.399999999999991473e+00 9.924417735023266518e-01
1.700000000000000122e-01 3.250000000000000000e+00 5.359999999999949694e+00 9.994844158907414400e-01
1.700000000000000122e-01 3.250000000000000000e+00 4.839999999999960778e+00 9.983974375875818152e-01
1.700000000000000122e-01 3.250000000000000000e+00 3.159999999999996589e+00 9.891120284164651721e-01
1.700000000000000122e-01 3.250000000000000000e+00 5.169999999999953744e+00 9.992249681785116966e-01
1.700000000000000122e-01 3.250000000000000000e+00 5.429999999999948201e+00 9.995552873268908067e-01
1.700000000000000122e-01 3.250000000000000000e+00 3.729999999999984439e+00 9.860296946885663827e-01
1.700000000000000122e-01 3.250000000000000000e+00 3.649999999999986144e+00 9.855850764159983513e-01
1.700000000000000122e-01 3.250000000000000000e+00 3.179999999999996163e+00 9.941579482331052153e-01
1.700000000000000122e-01 3.250000000000000000e+00 3.229999999999995097e+00 9.996455604772978010e-01
1.700000000000000122e-01 3.250000000000000000e+00 5.559999999999945430e+00 9.996609145521955231e-01
1.700000000000000122e-01 3.250000000000000000e+00 5.519999999999946283e+00 9.996315857262698668e-01
1.700000000000000122e-01 3.250000000000000000e+00 5.699999999999942446e+00 9.997454916024759441e-01
1.700000000000000122e-01 3.250000000000000000e+00 4.139999999999975699e+00 9.925791531142736934e-01
1.700000000000000122e-01 3.250000000000000000e+00 3.379999999999991900e+00 9.936574364728530950e-01
1.700000000000000122e-01 3.250000000000000000e+00 4.789999999999961844e+00 9.982082985830323940e-01
1.700000000000000122e-01 3.250000000000000000e+00 5.739999999999941593e+00 9.997652918691277701e-01
1.700000000000000122e-01 3.250000000000000000e+00 4.419999999999969731e+00 9.959092051440032733e-01
1.700000000000000122e-01 3.250000000000000000e+00 4.989999999999957581e+00 9.988509687661788483e-01
1.700000000000000122e-01 3.250000000000000000e+00 3.969999999999979323e+00 9.897829955836402460e-01
1.700000000000000122e-01 3.250000000000000000e+00 5.199999999999953104e+00 9.992736993876986107e-01
1.700000000000000122e-01 3.250000000000000000e+00 4.259999999999973141e+00 9.942123809348207830e-01
1.700000000000000122e-01 3.250000000000000000e+00 5.089999999999955449e+00 9.990775123963092641e-01
1.700000000000000122e-01 3.250000000000000000e+00 5.799999999999940314e+00 9.997919704731000889e-01
1.700000000000000122e-01 3.250000000000000000e+00 4.869999999999960139e+00 9.985009921665585209e-01
1.700000000000000122e-01 3.250000000000000000e+00 3.789999999999983160e+00 9.867656432053476534e-01
1.700000000000000122e-01 3.250000000000000000e+00 3.039999999999999147e+00 8.773388951379161860e-01
1.700000000000000122e-01 3.250000000000000000e+00 4.579999999999966320e+00 9.971335059026485981e-01
1.700000000000000122e-01 3.250000000000000000e+00 5.659999999999943299e+00 9.997238997976104491e-01
1.700000000000000122e-01 3.250000000000000000e+00 3.369999999999992113e+00 9.942858405624993567e-01
1.700000000000000122e-01 3.250000000000000000e+00 4.249999999999973355e+00 9.940884098428665050e-01
1.700000000000000122e-01 3.250000000000000000e+00 5.749999999999941380e+00 9.997699806073034878e-01
1.700000000000000122e-01 3.250000000000000000e+00 5.269999999999951612e+00 9.993753013260461282e-01
1.700000000000000122e-01 3.250000000000000000e+00 4.159999999999975273e+00 9.928732640112932772e-01
1.700000000000000122e-01 3.250000000000000000e+00 4.909999999999959286e+00 9.986284732575368972e-01
1.700000000000000122e-01 3.250000000000000000e+00 5.939999999999937330e+00 9.998424135036652061e-01
1.700000000000000122e-01 3.250000000000000000e+00 3.949999999999979750e+00 9.894309801159040241e-01
1.700000000000000122e-01 3.250000000000000000e+00 3.699999999999985079e+00 9.857747760187995922e-01
1.700000000000000122e-01 3.250000000000000000e+00 5.929999999999937543e+00 9.998392849812168803e-01
1.700000000000000122e-01 3.250000000000000000e+00 4.549999999999966960e+00 9.969348084188931480e-01
1.700000000000000122e-01 3.250000000000000000e+00 5.539999999999945857e+00 9.996465733184626279e-01
1.700000000000000122e-01 3.250000000000000000e+00 5.759999999999941167e+00 9.997745694871297273e-01
1.700000000000000122e-01 3.250000000000000000e+00 3.609999999999986997e+00 9.857054565179238503e-01
1.700000000000000122e-01 3.250000000000000000e+00 5.569999999999945217e+00 9.996678519497740334e-01
1.700000000000000122e-01 3.250000000000000000e+00 4.519999999999967599e+00 9.967227097557481708e-01
1.700000000000000122e-01 3.250000000000000000e+00 3.139999999999997016e+00 9.816516023368246913e-01
1.700000000000000122e-01 3.250000000000000000e+00 3.909999999999980602e+00 9.887262328509643927e-01
1.700000000000000122e-01 3.250000000000000000e+00 4.359999999999971010e+00 9.953339563510560373e-01
1.700000000000000122e-01 3.250000000000000000e+00 5.839999999999939462e+00 9.998079439124618606e-01
1.700000000000000122e-01 3.250000000000000000e+00 4.729999999999963123e+00 9.979510544929464100e-01
1.700000000000000122e-01 3.250000000000000000e+00 5.119999999999954809e+00 9.991359810548626763e-01
1.700000000000000122e-01 3.250000000000000000e+00 4.019999999999978257e+00 9.906501396629199263e-01
1.700000000000000122e-01 3.250000000000000000e+00 3.249999999999994671e+00 1.000000000000000000e+00
1.700000000000000122e-01 3.250000000000000000e+00 3.849999999999981881e+00 9.876971918006681728e-01
1.700000000000000122e-01 3.250000000000000000e+00 4.849999999999960565e+00 9.984327467152658286e-01
1.700000000000000122e-01 3.250000000000000000e+00 5.779999999999940741e+00 9.997834565848917610e-01
1.700000000000000122e-01 3.250000000000000000e+00 4.039999999999977831e+00 9.909888178567133332e-01
1.700000000000000122e-01 3.250000000000000000e+00 4.059999999999977405e+00 9.913214496387637853e-01
1.700000000000000122e-01 3.250000000000000000e+00 4.309999999999972076e+00 9.947996051798522199e-01
1.700000000000000122e-01 3.250000000000000000e+00 5.949999999999937117e+00 9.998454769099242023e-01
1.700000000000000122e-01 3.250000000000000000e+00 4.009999999999978471e+00 9.904787939688544096e-01
1.700000000000000122e-01 3.250000000000000000e+00 4.099999999999976552e+00 9.919658620171040164e-01
1.700000000000000122e-01 3.250000000000000000e+00 3.529999999999988702e+00 9.869205858033046619e-01
1.700000000000000122e-01 3.250000000000000000e+00 3.129999999999997229e+00 9.768029151733278459e-01
1.700000000000000122e-01 3.250000000000000000e+00 4.629999999999965254e+00 9.974368845922993998e-01
1.700000000000000122e-01 3.250000000000000000e+00 3.439999999999990621e+00 9.902594626513390175e-01
1.700000000000000122e-01 3.250000000000000000e+00 5.259999999999951825e+00 9.993617536162515691e-01
1.700000000000000122e-01 3.250000000000000000e+00 5.529999999999946070e+00 9.996391621940989847e-01
1.700000000000000122e-01 3.250000000000000000e+00 5.869999999999938822e+00 9.998190616994856450e-01
1.700000000000000122e-01 3.250000000000000000e+00 5.069999999999955875e+00 9.990362487795975133e-01
1.700000000000000122e-01 3.250000000000000000e+00 4.179999999999974847e+00 9.931587279416576042e-01
1.700000000000000122e-01 3.250000000000000000e+00 3.659999999999985931e+00 9.855957112188311608e-01
1.700000000000000122e-01 3.250000000000000000e+00 5.459999999999947562e+00 9.995824315368386781e-01
1.700000000000000122e-01 3.250000000000000000e+00 5.819999999999939888e+00 9.998001276646971691e-01
1.700000000000000122e-01 3.250000000000000000e+00 4.799999999999961631e+00 9.982478683425993760e-01
1.700000000000000122e-01 3.250000000000000000e+00 3.259999999999994458e+00 9.999256673457176392e-01
1.700000000000000122e-01 3.250000000000000000e+00 5.289999999999951186e+00 9.994014957601315974e-01
1.700000000000000122e-01 3.250000000000000000e+00 4.329999999999971649e+00 9.950195548210801766e-01
1.700000000000000122e-01 3.250000000000000000e+00 5.149999999999954170e+00 9.991905841778956354e-01
1.700000000000000122e-01 3.250000000000000000e+00 3.459999999999990195e+00 9.893221012316890661e-01
1.700000000000000122e-01 3.250000000000000000e+00 3.029999999999999361e+00 8.570040578042508184e-01
1.700000000000000122e-01 3.250000000000000000e+00 3.209999999999995524e+00 9.984044494518667934e-01
1.700000000000000122e-01 3.250000000000000000e+00 4.819999999999961204e+00 9.983243566827565418e-01
1.700000000000000122e-01 3.250000000000000000e+00 5.159999999999953957e+00 9.992079717693819196e-01
1.700000000000000122e-01 3.250000000000000000e+00 4.279999999999972715e+00 9.944537568114840687e-01
1.700000000000000122e-01 3.250000000000000000e+00 3.069999999999998508e+00 9.248694044718068774e-01
1.700000000000000122e-01 3.250000000000000000e+00 3.719999999999984652e+00 9.859347672816428654e-01
1.700000000000000122e-01 3.250000000000000000e+00 4.609999999999965681e+00 9.973195405946876368e-01
1.700000000000000122e-01 3.250000000000000000e+00 5.099999999999955236e+00 9.990974482858659966e-01
1.700000000000000122e-01 3.250000000000000000e+00 4.239999999999973568e+00 9.939622366674372156e-01
1.700000000000000122e-01 3.250000000000000000e+00 5.829999999999939675e+00 9.998040774507127582e-01
1.700000000000000122e-01 3.250000000000000000e+00 5.859999999999939035e+00 9.998154342448253296e-01
1.700000000000000122e-01 3.250000000000000000e+00 3.579999999999987637e+00 9.859927146012343879e-01
1.700000000000000122e-01 3.250000000000000000e+00 5.479999999999947136e+00 9.995995476777134181e-01
1.700000000000000122e-01 3.250000000000000000e+00 4.959999999999958220e+00 9.987722669196990033e-01
1.700000000000000122e-01 3.250000000000000000e+00 4.169999999999975060e+00 9.930170864396823394e-01
1.700000000000000122e-01 3.250000000000000000e+00 5.339999999999950120e+00 9.994620407637070381e-01
1.700000000000000122e-01 3.250000000000000000e+00 5.039999999999956515e+00 9.989707079859379002e-01
1.700000000000000122e-01 3.250000000000000000e+00 4.759999999999962483e+00 9.980840488395070764e-01
1.700000000000000122e-01 3.250000000000000000e+00 4.679999999999964189e+00 9.977083691045648406e-01
1.700000000000000122e-01 3.250000000000000000e+00 5.629999999999943938e+00 9.997064277153453471e-01
1.700000000000000122e-01 3.250000000000000000e+00 4.379999999999970584e+00 9.955334739066059591e-01
1.700000000000000122e-01 3.250000000000000000e+00 3.859999999999981668e+00 9.878641319165574197e-01
1.700000000000000122e-01 3.250000000000000000e+00 4.859999999999960352e+00 9.984672590347107857e-01
1.700000000000000122e-01 3.250000000000000000e+00 4.709999999999963549e+00 9.978572470063432620e-01
1.700000000000000122e-01 3.250000000000000000e+00 5.719999999999942020e+00 9.997556055830332244e-01
1.700000000000000122e-01 3.250000000000000000e+00 4.999999999999957367e+00 9.988760246975507684e-01
1.700000000000000122e-01 3.250000000000000000e+00 5.309999999999950759e+00 9.994265346156587793e-01
1.700000000000000122e-01 3.250000000000000000e+00 5.049999999999956302e+00 9.989930561178516077e-01
1.700000000000000122e-01 3.250000000000000000e+00 5.599999999999944578e+00 9.996877732194718869e-01
1.700000000000000122e-01 3.250000000000000000e+00 4.719999999999963336e+00 9.979046799592417027e-01
1.700000000000000122e-01 3.250000000000000000e+00 4.269999999999972928e+00 9.943341594157258934e-01
1.700000000000000122e-01 3.250000000000000000e+00 4.569999999999966533e+00 9.970687164802376490e-01
1.700000000000000122e-01 3.250000000000000000e+00 5.129999999999954596e+00 9.991545983610694570e-01
1.700000000000000122e-01 3.250000000000000000e+00 4.229999999999973781e+00 9.938338541626925426e-01
1.700000000000000122e-01 3.250000000000000000e+00 5.079999999999955662e+00 9.990571161625001473e-01
1.700000000000000122e-01 3.250000000000000000e+00 3.829999999999982307e+00 9.873716370831809863e-01
1.700000000000000122e-01 3.250000000000000000e+00 3.089999999999998082e+00 9.474321860414990359e-01
1.700000000000000122e-01 3.250000000000000000e+00 3.299999999999993605e+00 9.985254106455969669e-01
1.700000000000000122e-01 3.250000000000000000e+00 3.619999999999986784e+00 9.856490923103231605e-01
1.700000000000000122e-01 3.250000000000000000e+00 5.219999999999952678e+00 9.993043907471090836e-01
1.700000000000000122e-01 3.250000000000000000e+00 4.809999999999961418e+00 9.982865479126482589e-01
1.700000000000000122e-01 3.250000000000000000e+00 3.809999999999982734e+00 9.870599171363331203e-01
1.700000000000000122e-01 3.250000000000000000e+00 3.679999999999985505e+00 9.856596248091111789e-01
1.700000000000000122e-01 3.250000000000000000e+00 5.609999999999944365e+00 9.996941278476028092e-01
1.700000000000000122e-01 3.250000000000000000e+00 5.549999999999945643e+00 9.996538228753685251e-01
