1.700000000000000122e-01 3.250000000000000000e+00 3.539999999999988489e+00 -6.121358026049404266e+00
1.700000000000000122e-01 3.250000000000000000e+00 3.589999999999987423e+00 -5.942903947296902523e+00
1.700000000000000122e-01 3.250000000000000000e+00 5.279999999999951399e+00 -2.859440804580404460e+01
1.700000000000000122e-01 3.250000000000000000e+00 4.919999999999959073e+00 -1.930417632489353963e+01
1.700000000000000122e-01 3.250000000000000000e+00 3.289999999999993818e+00 -2.236338502219721391e+01
1.700000000000000122e-01 3.250000000000000000e+00 4.469999999999968665e+00 -1.168036701295485713e+01
1.700000000000000122e-01 3.250000000000000000e+00 5.139999999999954383e+00 -2.458378765231645957e+01
1.700000000000000122e-01 3.250000000000000000e+00 5.639999999999943725e+00 -4.169311967168766131e+01
1.700000000000000122e-01 3.250000000000000000e+00 3.519999999999988916e+00 -6.238740490852226372e+00
1.700000000000000122e-01 3.250000000000000000e+00 5.059999999999956088e+00 -2.252729298300087279e+01
1.700000000000000122e-01 3.250000000000000000e+00 3.689999999999985292e+00 -5.908384014149108410e+00
1.700000000000000122e-01 3.250000000000000000e+00 4.079999999999976978e+00 -7.731601307374545762e+00
1.700000000000000122e-01 3.250000000000000000e+00 3.999999999999978684e+00 -7.176093172528799968e+00
1.700000000000000122e-01 3.250000000000000000e+00 3.769999999999983586e+00 -6.077327958478108805e+00
1.700000000000000122e-01 3.250000000000000000e+00 3.839999999999982094e+00 -6.326302789333650090e+00
1.700000000000000122e-01 3.250000000000000000e+00 3.739999999999984226e+00 -5.997916916141167398e+00
1.700000000000000122e-01 3.250000000000000000e+00 4.149999999999975486e+00 -8.286535044613891898e+00
1.700000000000000122e-01 3.250000000000000000e+00 3.819999999999982521e+00 -6.246704306588396705e+00
1.700000000000000122e-01 3.250000000000000000e+00 3.959999999999979536e+00 -6.930133984612018239e+00
1.700000000000000122e-01 3.250000000000000000e+00 4.369999999999970797e+00 -1.046129221528898157e+01
1.700000000000000122e-01 3.250000000000000000e+00 3.549999999999988276e+00 -6.073707589779723470e+00
1.700000000000000122e-01 3.250000000000000000e+00 3.329999999999992966e+00 -1.253392381763656260e+01
1.700000000000000122e-01 3.250000000000000000e+00 4.189999999999974634e+00 -8.632679076279103469e+00
1.700000000000000122e-01 3.250000000000000000e+00 4.619999999999965468e+00 -1.380845971407309669e+01
1.700000000000000122e-01 3.250000000000000000e+00 5.899999999999938183e+00 -5.415129136980960567e+01
1.700000000000000122e-01 3.250000000000000000e+00 3.359999999999992326e+00 -9.918825237533411610e+00
1.700000000000000122e-01 3.250000000000000000e+00 4.449999999999969091e+00 -1.142428841044690735e+01
1.700000000000000122e-01 3.250000000000000000e+00 4.349999999999971223e+00 -1.023546397483196024e+01
1.700000000000000122e-01 3.250000000000000000e+00 4.209999999999974207e+00 -8.813766824679904133e+00
1.700000000000000122e-01 3.250000000000000000e+00 4.489999999999968239e+00 -1.194275065524116108e+01
1.700000000000000122e-01 3.250000000000000000e+00 3.989999999999978897e+00 -7.112593881972009591e+00
1.700000000000000122e-01 3.250000000000000000e+00 3.000000000000000000e+00 1.475684182571069369e+00
1.700000000000000122e-01 3.250000000000000000e+00 3.509999999999989129e+00 -6.310024486480410921e+00
1.700000000000000122e-01 3.250000000000000000e+00 5.769999999999940954e+00 -4.757081237984981215e+01
1.700000000000000122e-01 3.250000000000000000e+00 5.379999999999949267e+00 -3.180679489133223115e+01
1.700000000000000122e-01 3.250000000000000000e+00 3.899999999999980815e+00 -6.602224601963404105e+00
1.700000000000000122e-01 3.250000000000000000e+00 4.639999999999965041e+00 -1.412120465470285602e+01
1.700000000000000122e-01 3.250000000000000000e+00 3.419999999999991047e+00 -7.576790380171284589e+00
1.700000000000000122e-01 3.250000000000000000e+00 3.479999999999989768e+00 -6.586418562294647394e+00
1.700000000000000122e-01 3.250000000000000000e+00 5.849999999999939249e+00 -5.153311148452988988e+01
1.700000000000000122e-01 3.250000000000000000e+00 3.059999999999998721e+00 2.353073302667029409e+00
1.700000000000000122e-01 3.250000000000000000e+00 4.029999999999978044e+00 -7.374545212777492864e+00
1.700000000000000122e-01 3.250000000000000000e+00 3.869999999999981455e+00 -6.457502443118886326e+00
1.700000000000000122e-01 3.250000000000000000e+00 4.389999999999970370e+00 -1.069300991458221795e+01
1.700000000000000122e-01 3.250000000000000000e+00 5.649999999999943512e+00 -4.212170987238686592e+01
1.700000000000000122e-01 3.250000000000000000e+00 5.179999999999953531e+00 -2.567458031110421146e+01
1.700000000000000122e-01 3.250000000000000000e+00 5.959999999999936904e+00 -5.744334403896090180e+01
1.700000000000000122e-01 3.250000000000000000e+00 3.319999999999993179e+00 -1.392378976035774762e+01
1.700000000000000122e-01 3.250000000000000000e+00 3.079999999999998295e+00 2.800835976567368046e+00
1.700000000000000122e-01 3.250000000000000000e+00 3.929999999999980176e+00 -6.759908537437867793e+00
1.700000000000000122e-01 3.250000000000000000e+00 3.119999999999997442e+00 4.147645890355088127e+00
1.700000000000000122e-01 3.250000000000000000e+00 3.109999999999997655e+00 3.734218314620413981e+00
1.700000000000000122e-01 3.250000000000000000e+00 5.889999999999938396e+00 -5.361869328688102598e+01
1.700000000000000122e-01 3.250000000000000000e+00 5.399999999999948841e+00 -3.248633118445128076e+01
1.700000000000000122e-01 3.250000000000000000e+00 4.979999999999957794e+00 -2.062932743220592968e+01
1.700000000000000122e-01 3.250000000000000000e+00 3.469999999999989981e+00 -6.703861047607349022e+00
1.700000000000000122e-01 3.250000000000000000e+00 4.119999999999976126e+00 -8.040825538574635445e+00
1.700000000000000122e-01 3.250000000000000000e+00 5.329999999999950333e+00 -3.016265976354395306e+01
1.700000000000000122e-01 3.250000000000000000e+00 3.409999999999991260e+00 -7.832785100420900370e+00
1.700000000000000122e-01 3.250000000000000000e+00 3.019999999999999574e+00 1.711051263502071818e+00
1.700000000000000122e-01 3.250000000000000000e+00 3.389999999999991687e+00 -8.471775429168920013e+00
1.700000000000000122e-01 3.250000000000000000e+00 3.499999999999989342e+00 -6.390947079479731840e+00
1.700000000000000122e-01 3.250000000000000000e+00 3.749999999999984013e+00 -6.022401199597043231e+00
1.700000000000000122e-01 3.250000000000000000e+00 5.319999999999950546e+00 -2.984302838219652898e+01
1.700000000000000122e-01 3.250000000000000000e+00 3.559999999999988063e+00 -6.032551427070807826e+00
1.700000000000000122e-01 3.250000000000000000e+00 5.239999999999952252e+00 -2.739258252573704766e+01
1.700000000000000122e-01 3.250000000000000000e+00 5.729999999999941807e+00 -4.569034754706184032e+01
1.700000000000000122e-01 3.250000000000000000e+00 4.429999999999969518e+00 -1.117442621767205502e+01
1.700000000000000122e-01 3.250000000000000000e+00 5.419999999999948415e+00 -3.317864932313215576e+01
1.700000000000000122e-01 3.250000000000000000e+00 5.349999999999949907e+00 -3.081105024841492579e+01
1.700000000000000122e-01 3.250000000000000000e+00 4.509999999999967812e+00 -1.221153053796958687e+01
1.700000000000000122e-01 3.250000000000000000e+00 5.029999999999956728e+00 -2.179749764129945078e+01
1.700000000000000122e-01 3.250000000000000000e+00 4.669999999999964402e+00 -1.460377359252056273e+01
1.700000000000000122e-01 3.250000000000000000e+00 4.289999999999972502e+00 -9.592589753765633276e+00
1.700000000000000122e-01 3.250000000000000000e+00 5.809999999999940101e+00 -4.951778231167988054e+01
1.700000000000000122e-01 3.250000000000000000e+00 5.619999999999944151e+00 -4.084730160364314600e+01
1.700000000000000122e-01 3.250000000000000000e+00 5.469999999999947349e+00 -3.496660503501267669e+01
1.700000000000000122e-01 3.250000000000000000e+00 5.229999999999952465e+00 -2.709927567946813909e+01
1.700000000000000122e-01 3.250000000000000000e+00 5.009999999999957154e+00 -2.132309866077963179e+01
1.700000000000000122e-01 3.250000000000000000e+00 4.339999999999971436e+00 -1.012473506523776123e+01
1.700000000000000122e-01 3.250000000000000000e+00 3.629999999999986571e+00 -5.887696525164096251e+00
1.700000000000000122e-01 3.250000000000000000e+00 3.569999999999987850e+00 -5.997342469988740987e+00
1.700000000000000122e-01 3.250000000000000000e+00 3.919999999999980389e+00 -6.705935530181150739e+00
1.700000000000000122e-01 3.250000000000000000e+00 5.669999999999943086e+00 -4.299038666417634857e+01
1.700000000000000122e-01 3.250000000000000000e+00 4.399999999999970157e+00 -1.081110137707962338e+01
1.700000000000000122e-01 3.250000000000000000e+00 4.459999999999968878e+00 -1.155154518230377469e+01
1.700000000000000122e-01 3.250000000000000000e+00 5.709999999999942233e+00 -4.477448573260477360e+01
1.700000000000000122e-01 3.250000000000000000e+00 3.489999999999989555e+00 -6.482636546713143488e+00
1.700000000000000122e-01 3.250000000000000000e+00 5.209999999999952891e+00 -2.652109258249372203e+01
1.700000000000000122e-01 3.250000000000000000e+00 4.929999999999958860e+00 -1.951937612282869949e+01
1.700000000000000122e-01 3.250000000000000000e+00 5.299999999999950973e+00 -2.921278146502019624e+01
1.700000000000000122e-01 3.250000000000000000e+00 5.249999999999952038e+00 -2.768872779247776350e+01
1.700000000000000122e-01 3.250000000000000000e+00 5.969999999999936691e+00 -5.800838759322177651e+01
1.700000000000000122e-01 3.250000000000000000e+00 4.479999999999968452e+00 -1.181076506340257559e+01
1.700000000000000122e-01 3.250000000000000000e+00 4.939999999999958646e+00 -1.973681604561378222e+01
1.700000000000000122e-01 3.250000000000000000e+00 4.879999999999959925e+00 -1.846543410667285201e+01
1.700000000000000122e-01 3.250000000000000000e+00 4.949999999999958433e+00 -1.995651352299444881e+01
1.700000000000000122e-01 3.250000000000000000e+00 4.199999999999974420e+00 -8.722550954199897788e+00
1.700000000000000122e-01 3.250000000000000000e+00 4.769999999999962270e+00 -1.633352006665410983e+01
1.700000000000000122e-01 3.250000000000000000e+00 5.389999999999949054e+00 -3.214497697918031349e+01
1.700000000000000122e-01 3.250000000000000000e+00 4.219999999999973994e+00 -8.906332095672565785e+00
1.700000000000000122e-01 3.250000000000000000e+00 4.129999999999975913e+00 -8.121411688551281927e+00
1.700000000000000122e-01 3.250000000000000000e+00 3.169999999999996376e+00 7.850746032680053332e+00
1.700000000000000122e-01 3.250000000000000000e+00 3.199999999999995737e+00 1.374465445330964641e+01
1.700000000000000122e-01 3.250000000000000000e+00 5.879999999999938609e+00 -5.309060661786461566e+01
1.700000000000000122e-01 3.250000000000000000e+00 3.239999999999994884e+00 7.735757568349258406e+01
1.700000000000000122e-01 3.250000000000000000e+00 4.899999999999959499e+00 -1.888042800172288338e+01
1.700000000000000122e-01 3.250000000000000000e+00 4.689999999999963975e+00 -1.493461610660652283e+01
1.700000000000000122e-01 3.250000000000000000e+00 4.659999999999964615e+00 -1.444110533758239079e+01
1.700000000000000122e-01 3.250000000000000000e+00 5.579999999999945004e+00 -3.920037321065132829e+01
1.700000000000000122e-01 3.250000000000000000e+00 3.349999999999992539e+00 -1.060902385617669985e+01
1.700000000000000122e-01 3.250000000000000000e+00 4.439999999999969305e+00 -1.129858569954942382e+01
1.700000000000000122e-01 3.250000000000000000e+00 3.219999999999995310e+00 2.431007666464390837e+01
1.700000000000000122e-01 3.250000000000000000e+00 3.339999999999992752e+00 -1.146060987313387436e+01
1.700000000000000122e-01 3.250000000000000000e+00 3.399999999999991473e+00 -8.128326308083469343e+00
1.700000000000000122e-01 3.250000000000000000e+00 5.359999999999949694e+00 -3.113985450018368084e+01
1.700000000000000122e-01 3.250000000000000000e+00 4.839999999999960778e+00 -1.766117160208191805e+01
1.700000000000000122e-01 3.250000000000000000e+00 3.159999999999996589e+00 6.770436590997026549e+00
1.700000000000000122e-01 3.250000000000000000e+00 5.169999999999953744e+00 -2.539786332163079052e+01
1.700000000000000122e-01 3.250000000000000000e+00 5.429999999999948201e+00 -3.352966028256063424e+01
1.700000000000000122e-01 3.250000000000000000e+00 3.729999999999984439e+00 -5.975512390675405960e+00
1.700000000000000122e-01 3.250000000000000000e+00 3.649999999999986144e+00 -5.882416244101965397e+00
1.700000000000000122e-01 3.250000000000000000e+00 3.179999999999996163e+00 9.246782533092842371e+00
1.700000000000000122e-01 3.250000000000000000e+00 3.229999999999995097e+00 3.755788278516696721e+01
1.700000000000000122e-01 3.250000000000000000e+00 5.559999999999945430e+00 -3.839884430071125365e+01
1.700000000000000122e-01 3.250000000000000000e+00 5.519999999999946283e+00 -3.683862772224554760e+01
1.700000000000000122e-01 3.250000000000000000e+00 5.699999999999942446e+00 -4.432254937898319014e+01
1.700000000000000122e-01 3.250000000000000000e+00 4.139999999999975699e+00 -8.203313919414998878e+00
1.700000000000000122e-01 3.250000000000000000e+00 3.379999999999991900e+00 -8.874068501757493621e+00
1.700000000000000122e-01 3.250000000000000000e+00 4.789999999999961844e+00 -1.670272452546913655e+01
1.700000000000000122e-01 3.250000000000000000e+00 5.739999999999941593e+00 -4.615432883907561035e+01
1.700000000000000122e-01 3.250000000000000000e+00 4.419999999999969731e+00 -1.105179930166023361e+01
1.700000000000000122e-01 3.250000000000000000e+00 4.989999999999957581e+00 -2.085823189515796727e+01
1.700000000000000122e-01 3.250000000000000000e+00 3.969999999999979323e+00 -6.989606898263244439e+00
1.700000000000000122e-01 3.250000000000000000e+00 5.199999999999953104e+00 -2.623617432127159788e+01
1.700000000000000122e-01 3.250000000000000000e+00 4.259999999999973141e+00 -9.290206112243950543e+00
1.700000000000000122e-01 3.250000000000000000e+00 5.089999999999955449e+00 -2.327937633301279163e+01
1.700000000000000122e-01 3.250000000000000000e+00 5.799999999999940314e+00 -4.902470424417196426e+01
1.700000000000000122e-01 3.250000000000000000e+00 4.869999999999960139e+00 -1.826117780686296044e+01
1.700000000000000122e-01 3.250000000000000000e+00 3.789999999999983160e+00 -6.139789036093706187e+00
1.700000000000000122e-01 3.250000000000000000e+00 3.039999999999999147e+00 1.997970017886068872e+00
1.700000000000000122e-01 3.250000000000000000e+00 4.579999999999966320e+00 -1.320400499095448232e+01
1.700000000000000122e-01 3.250000000000000000e+00 5.659999999999943299e+00 -4.255412321753602356e+01
1.700000000000000122e-01 3.250000000000000000e+00 3.369999999999992113e+00 -9.349788908719233405e+00
1.700000000000000122e-01 3.250000000000000000e+00 4.249999999999973355e+00 -9.192183039314844706e+00
1.700000000000000122e-01 3.250000000000000000e+00 5.749999999999941380e+00 -4.662238119050447693e+01
1.700000000000000122e-01 3.250000000000000000e+00 5.269999999999951612e+00 -2.828961902963470010e+01
1.700000000000000122e-01 3.250000000000000000e+00 4.159999999999975273e+00 -8.371078297411170155e+00
1.700000000000000122e-01 3.250000000000000000e+00 4.909999999999959286e+00 -1.909119934549073250e+01
1.700000000000000122e-01 3.250000000000000000e+00 5.939999999999937330e+00 -5.632741214146087572e+01
1.700000000000000122e-01 3.250000000000000000e+00 3.949999999999979750e+00 -6.872019699297791995e+00
1.700000000000000122e-01 3.250000000000000000e+00 3.699999999999985079e+00 -5.921602752011416726e+00
1.700000000000000122e-01 3.250000000000000000e+00 5.929999999999937543e+00 -5.577646085706048495e+01
1.700000000000000122e-01 3.250000000000000000e+00 4.549999999999966960e+00 -1.276865623405748451e+01
1.700000000000000122e-01 3.250000000000000000e+00 5.539999999999945857e+00 -3.761166367002206812e+01
1.700000000000000122e-01 3.250000000000000000e+00 5.759999999999941167e+00 -4.709453289080794036e+01
1.700000000000000122e-01 3.250000000000000000e+00 3.609999999999986997e+00 -5.907192984366617772e+00
1.700000000000000122e-01 3.250000000000000000e+00 5.569999999999945217e+00 -3.879780240760553056e+01
1.700000000000000122e-01 3.250000000000000000e+00 4.519999999999967599e+00 -1.234834825378880829e+01
1.700000000000000122e-01 3.250000000000000000e+00 3.139999999999997016e+00 5.212182747540613725e+00
1.700000000000000122e-01 3.250000000000000000e+00 3.909999999999980602e+00 -6.653369066819199595e+00
1.700000000000000122e-01 3.250000000000000000e+00 4.359999999999971010e+00 -1.034764662951638670e+01
1.700000000000000122e-01 3.250000000000000000e+00 5.839999999999939462e+00 -5.102276764321305791e+01
1.700000000000000122e-01 3.250000000000000000e+00 4.729999999999963123e+00 -1.561872636843539830e+01
1.700000000000000122e-01 3.250000000000000000e+00 5.119999999999954809e+00 -2.405426519498315230e+01
1.700000000000000122e-01 3.250000000000000000e+00 4.019999999999978257e+00 -7.307073504046360135e+00
1.700000000000000122e-01 3.250000000000000000e+00 3.249999999999994671e+00 1.576890625830005625e+14
1.700000000000000122e-01 3.250000000000000000e+00 3.849999999999981881e+00 -6.368492098220118081e+00
1.700000000000000122e-01 3.250000000000000000e+00 4.849999999999960565e+00 -1.785906305799881721e+01
1.700000000000000122e-01 3.250000000000000000e+00 5.779999999999940741e+00 -4.805124824837694320e+01
1.700000000000000122e-01 3.250000000000000000e+00 4.039999999999977831e+00 -7.443333059951104502e+00
1.700000000000000122e-01 3.250000000000000000e+00 4.059999999999977405e+00 -7.584846918155054851e+00
1.700000000000000122e-01 3.250000000000000000e+00 4.309999999999972076e+00 -9.801182036581867152e+00
1.700000000000000122e-01 3.250000000000000000e+00 5.949999999999937117e+00 -5.688302940528344465e+01
1.700000000000000122e-01 3.250000000000000000e+00 4.009999999999978471e+00 -7.240921406460833154e+00
1.700000000000000122e-01 3.250000000000000000e+00 4.099999999999976552e+00 -7.883592445286234707e+00
1.700000000000000122e-01 3.250000000000000000e+00 3.529999999999988702e+00 -6.176128973749407614e+00
1.700000000000000122e-01 3.250000000000000000e+00 3.129999999999997229e+00 4.633670767915999633e+00
1.700000000000000122e-01 3.250000000000000000e+00 4.629999999999965254e+00 -1.396394455202109164e+01
1.700000000000000122e-01 3.250000000000000000e+00 3.439999999999990621e+00 -7.158802666470959863e+00
1.700000000000000122e-01 3.250000000000000000e+00 5.259999999999951825e+00 -2.798773280782545214e+01
1.700000000000000122e-01 3.250000000000000000e+00 5.529999999999946070e+00 -3.722339024735963164e+01
1.700000000000000122e-01 3.250000000000000000e+00 5.869999999999938822e+00 -5.256700092345408137e+01
1.700000000000000122e-01 3.250000000000000000e+00 5.069999999999955875e+00 -2.277548564035254586e+01
1.700000000000000122e-01 3.250000000000000000e+00 4.179999999999974847e+00 -8.544146109617543061e+00
1.700000000000000122e-01 3.250000000000000000e+00 3.659999999999985931e+00 -5.884592604007585770e+00
1.700000000000000122e-01 3.250000000000000000e+00 5.459999999999947562e+00 -3.460238573040839327e+01
1.700000000000000122e-01 3.250000000000000000e+00 5.819999999999939888e+00 -5.001513264012275073e+01
1.700000000000000122e-01 3.250000000000000000e+00 4.799999999999961631e+00 -1.689033260437293293e+01
1.700000000000000122e-01 3.250000000000000000e+00 3.259999999999994458e+00 -8.201484934658765269e+01
1.700000000000000122e-01 3.250000000000000000e+00 5.289999999999951186e+00 -2.890212157460565123e+01
1.700000000000000122e-01 3.250000000000000000e+00 4.329999999999971649e+00 -1.001545091862033843e+01
1.700000000000000122e-01 3.250000000000000000e+00 5.149999999999954170e+00 -2.485248723008205829e+01
1.700000000000000122e-01 3.250000000000000000e+00 3.459999999999990195e+00 -6.836831835700063920e+00
1.700000000000000122e-01 3.250000000000000000e+00 3.029999999999999361e+00 1.847169149306397307e+00
1.700000000000000122e-01 3.250000000000000000e+00 3.209999999999995524e+00 1.769994662065920465e+01
1.700000000000000122e-01 3.250000000000000000e+00 4.819999999999961204e+00 -1.727163893901227709e+01
1.700000000000000122e-01 3.250000000000000000e+00 5.159999999999953957e+00 -2.512383906174894221e+01
1.700000000000000122e-01 3.250000000000000000e+00 4.279999999999972715e+00 -9.490402205990699613e+00
1.700000000000000122e-01 3.250000000000000000e+00 3.069999999999998508e+00 2.563417071341838493e+00
1.700000000000000122e-01 3.250000000000000000e+00 3.719999999999984652e+00 -5.955266287529159541e+00
1.700000000000000122e-01 3.250000000000000000e+00 4.609999999999965681e+00 -1.365473663795455472e+01
1.700000000000000122e-01 3.250000000000000000e+00 5.099999999999955236e+00 -2.353511282671675886e+01
1.700000000000000122e-01 3.250000000000000000e+00 4.239999999999973568e+00 -9.095534031598896618e+00
1.700000000000000122e-01 3.250000000000000000e+00 5.829999999999939675e+00 -5.051678458190263399e+01
1.700000000000000122e-01 3.250000000000000000e+00 5.859999999999939035e+00 -5.204784592110377162e+01
1.700000000000000122e-01 3.250000000000000000e+00 3.579999999999987637e+00 -5.967600834091754791e+00
1.700000000000000122e-01 3.250000000000000000e+00 5.479999999999947136e+00 -3.533418674287035799e+01
1.700000000000000122e-01 3.250000000000000000e+00 4.959999999999958220e+00 -2.017848610816883692e+01
1.700000000000000122e-01 3.250000000000000000e+00 4.169999999999975060e+00 -8.456947312632838276e+00
1.700000000000000122e-01 3.250000000000000000e+00 5.339999999999950120e+00 -3.048532621637870221e+01
1.700000000000000122e-01 3.250000000000000000e+00 5.039999999999956515e+00 -2.203831783797866706e+01
1.700000000000000122e-01 3.250000000000000000e+00 4.759999999999962483e+00 -1.615189267118368832e+01
1.700000000000000122e-01 3.250000000000000000e+00 4.679999999999964189e+00 -1.476827245996250859e+01
1.700000000000000122e-01 3.250000000000000000e+00 5.629999999999943938e+00 -4.126832580412228424e+01
1.700000000000000122e-01 3.250000000000000000e+00 4.379999999999970584e+00 -1.057641011716414248e+01
1.700000000000000122e-01 3.250000000000000000e+00 3.859999999999981668e+00 -6.412234352628818357e+00
1.700000000000000122e-01 3.250000000000000000e+00 4.859999999999960352e+00 -1.805905964574025546e+01
1.700000000000000122e-01 3.250000000000000000e+00 4.709999999999963549e+00 -1.527289505549737036e+01
1.700000000000000122e-01 3.250000000000000000e+00 5.719999999999942020e+00 -4.523040917493129598e+01
1.700000000000000122e-01 3.250000000000000000e+00 4.999999999999957367e+00 -2.108948291423405053e+01
1.700000000000000122e-01 3.250000000000000000e+00 5.309999999999950759e+00 -2.952640969707654861e+01
1.700000000000000122e-01 3.250000000000000000e+00 5.049999999999956302e+00 -2.228157668781512868e+01
1.700000000000000122e-01 3.250000000000000000e+00 5.599999999999944578e+00 -4.001645626337155193e+01
1.700000000000000122e-01 3.250000000000000000e+00 4.719999999999963336e+00 -1.544485934035945007e+01
1.700000000000000122e-01 3.250000000000000000e+00 4.269999999999972928e+00 -9.389610122528043945e+00
1.700000000000000122e-01 3.250000000000000000e+00 4.569999999999966533e+00 -1.305719666012661229e+01
1.700000000000000122e-01 3.250000000000000000e+00 5.129999999999954596e+00 -2.431772028093925186e+01
1.700000000000000122e-01 3.250000000000000000e+00 4.229999999999973781e+00 -9.000252489544234180e+00
1.700000000000000122e-01 3.250000000000000000e+00 5.079999999999955662e+00 -2.302617370148796994e+01
1.700000000000000122e-01 3.250000000000000000e+00 3.829999999999982307e+00 -6.285696064424762142e+00
1.700000000000000122e-01 3.250000000000000000e+00 3.089999999999998082e+00 3.070463545342743128e+00
1.700000000000000122e-01 3.250000000000000000e+00 3.299999999999993605e+00 -1.841179257080920451e+01
1.700000000000000122e-01 3.250000000000000000e+00 3.619999999999986784e+00 -5.895553273993645149e+00
1.700000000000000122e-01 3.250000000000000000e+00 5.219999999999952678e+00 -2.680878605493631639e+01
1.700000000000000122e-01 3.250000000000000000e+00 4.809999999999961418e+00 -1.707996546872859867e+01
1.700000000000000122e-01 3.250000000000000000e+00 3.809999999999982734e+00 -6.209362882323959276e+00
1.700000000000000122e-01 3.250000000000000000e+00 3.679999999999985505e+00 -5.897723118237876427e+00
1.700000000000000122e-01 3.250000000000000000e+00 5.609999999999944365e+00 -4.043002054901671727e+01
1.700000000000000122e-01 3.250000000000000000e+00 5.549999999999945643e+00 -3.800347322820513796e+01
