1.700000000000000122e-01 3.250000000000000000e+00 3.539999999999988489e+00 8.492833160557907712e-01
1.700000000000000122e-01 3.250000000000000000e+00 3.589999999999987423e+00 8.451273900485963830e-01
1.700000000000000122e-01 3.250000000000000000e+00 5.279999999999951399e+00 9.656325764489268604e-01
1.700000000000000122e-01 3.250000000000000000e+00 4.919999999999959073e+00 9.495166037791941127e-01
1.700000000000000122e-01 3.250000000000000000e+00 3.289999999999993818e+00 9.562690717657391648e-01
1.700000000000000122e-01 3.250000000000000000e+00 4.469999999999968665e+00 9.179487221265821839e-01
1.700000000000000122e-01 3.250000000000000000e+00 5.139999999999954383e+00 9.601389990202042757e-01
1.700000000000000122e-01 3.250000000000000000e+00 5.639999999999943725e+00 9.763005760308754999e-01
1.700000000000000122e-01 3.250000000000000000e+00 3.519999999999988916e+00 8.518977563413584475e-01
1.700000000000000122e-01 3.250000000000000000e+00 5.059999999999956088e+00 9.565802464516666159e-01
1.700000000000000122e-01 3.250000000000000000e+00 3.689999999999985292e+00 8.442969443587781120e-01
1.700000000000000122e-01 3.250000000000000000e+00 4.079999999999976978e+00 8.786757690151301148e-01
1.700000000000000122e-01 3.250000000000000000e+00 3.999999999999978684e+00 8.699221179880107790e-01
1.700000000000000122e-01 3.250000000000000000e+00 3.769999999999983586e+00 8.482787360982079194e-01
1.700000000000000122e-01 3.250000000000000000e+00 3.839999999999982094e+00 8.537898366878423628e-01
1.700000000000000122e-01 3.250000000000000000e+00 3.739999999999984226e+00 8.464327289527812104e-01
1.700000000000000122e-01 3.250000000000000000e+00 4.149999999999975486e+00 8.863195733092177342e-01
1.700000000000000122e-01 3.250000000000000000e+00 3.819999999999982521e+00 8.520718589115308106e-01
1.700000000000000122e-01 3.250000000000000000e+00 3.959999999999979536e+00 8.656303107565264110e-01
1.700000000000000122e-01 3.250000000000000000e+00 4.369999999999970797e+00 9.088361215999275489e-01
1.700000000000000122e-01 3.250000000000000000e+00 3.549999999999988276e+00 8.481955398903833210e-01
1.700000000000000122e-01 3.250000000000000000e+00 3.329999999999992966e+00 9.233162456143505503e-01
1.700000000000000122e-01 3.250000000000000000e+00 4.189999999999974634e+00 8.906186953896975123e-01
1.700000000000000122e-01 3.250000000000000000e+00 4.619999999999965468e+00 9.301407377298703816e-01
1.700000000000000122e-01 3.250000000000000000e+00 5.899999999999938183e+00 9.817026859312993903e-01
1.700000000000000122e-01 3.250000000000000000e+00 3.359999999999992326e+00 9.040972102640828512e-01
1.700000000000000122e-01 3.250000000000000000e+00 4.449999999999969091e+00 9.161888163613290947e-01
1.700000000000000122e-01 3.250000000000000000e+00 4.349999999999971223e+00 9.069213672244125224e-01
1.700000000000000122e-01 3.250000000000000000e+00 4.209999999999974207e+00 8.927409165584685447e-01
1.700000000000000122e-01 3.250000000000000000e+00 4.489999999999968239e+00 9.196769572601370957e-01
1.700000000000000122e-01 3.250000000000000000e+00 3.989999999999978897e+00 8.688405270443738670e-01
1.700000000000000122e-01 3.250000000000000000e+00 3.000000000000000000e+00 1.969248053523504849e+00
1.700000000000000122e-01 3.250000000000000000e+00 3.509999999999989129e+00 8.534417474946539572e-01
1.700000000000000122e-01 3.250000000000000000e+00 5.769999999999940954e+00 9.791981139791335886e-01
1.700000000000000122e-01 3.250000000000000000e+00 5.379999999999949267e+00 9.690492692252125062e-01
1.700000000000000122e-01 3.250000000000000000e+00 3.899999999999980815e+00 8.594487368834603513e-01
1.700000000000000122e-01 3.250000000000000000e+00 4.639999999999965041e+00 9.316337737997627544e-01
1.700000000000000122e-01 3.250000000000000000e+00 3.419999999999991047e+00 8.763567633396437406e-01
1.700000000000000122e-01 3.250000000000000000e+00 3.479999999999989768e+00 8.591363991190562599e-01
1.700000000000000122e-01 3.250000000000000000e+00 5.849999999999939249e+00 9.807820655989062386e-01
1.700000000000000122e-01 3.250000000000000000e+00 3.059999999999998721e+00 1.529553918023221382e+00
1.700000000000000122e-01 3.250000000000000000e+00 4.029999999999978044e+00 8.731904576801892137e-01
1.700000000000000122e-01 3.250000000000000000e+00 3.869999999999981455e+00 8.565362550100751315e-01
1.700000000000000122e-01 3.250000000000000000e+00 4.389999999999970370e+00 9.107206790065360824e-01
1.700000000000000122e-01 3.250000000000000000e+00 5.649999999999943512e+00 9.765388674441096706e-01
1.700000000000000122e-01 3.250000000000000000e+00 5.179999999999953531e+00 9.617997307834142973e-01
1.700000000000000122e-01 3.250000000000000000e+00 5.959999999999936904e+00 9.827421944533748510e-01
1.700000000000000122e-01 3.250000000000000000e+00 3.319999999999993179e+00 9.306988463098873066e-01
1.700000000000000122e-01 3.250000000000000000e+00 3.079999999999998295e+00 1.429087686640507782e+00
1.700000000000000122e-01 3.250000000000000000e+00 3.929999999999980176e+00 8.624906285507950576e-01
1.700000000000000122e-01 3.250000000000000000e+00 3.119999999999997442e+00 1.272649084134606978e+00
1.700000000000000122e-01 3.250000000000000000e+00 3.109999999999997655e+00 1.307077413436432023e+00
1.700000000000000122e-01 3.250000000000000000e+00 5.889999999999938396e+00 9.815226269854313568e-01
1.700000000000000122e-01 3.250000000000000000e+00 5.399999999999948841e+00 9.696867700532607603e-01
1.700000000000000122e-01 3.250000000000000000e+00 4.979999999999957794e+00 9.526814630143517482e-01
1.700000000000000122e-01 3.250000000000000000e+00 3.469999999999989981e+00 8.614245819407561067e-01
1.700000000000000122e-01 3.250000000000000000e+00 4.119999999999976126e+00 8.830571660563750758e-01
1.700000000000000122e-01 3.250000000000000000e+00 5.329999999999950333e+00 9.673899813496310562e-01
1.700000000000000122e-01 3.250000000000000000e+00 3.409999999999991260e+00 8.801450904164719313e-01
1.700000000000000122e-01 3.250000000000000000e+00 3.019999999999999574e+00 1.793978942045021618e+00
1.700000000000000122e-01 3.250000000000000000e+00 3.389999999999991687e+00 8.886613836425361068e-01
1.700000000000000122e-01 3.250000000000000000e+00 3.499999999999989342e+00 8.551560332680949728e-01
1.700000000000000122e-01 3.250000000000000000e+00 3.749999999999984013e+00 8.470066562921412245e-01
1.700000000000000122e-01 3.250000000000000000e+00 5.319999999999950546e+00 9.670465330539639304e-01
1.700000000000000122e-01 3.250000000000000000e+00 3.559999999999988063e+00 8.472433313821881029e-01
1.700000000000000122e-01 3.250000000000000000e+00 5.239999999999952252e+00 9.641520843231544680e-01
1.700000000000000122e-01 3.250000000000000000e+00 5.729999999999941807e+00 9.783513099817525704e-01
1.700000000000000122e-01 3.250000000000000000e+00 4.429999999999969518e+00 9.143973601366111037e-01
1.700000000000000122e-01 3.250000000000000000e+00 5.419999999999948415e+00 9.703098120113273772e-01
1.700000000000000122e-01 3.250000000000000000e+00 5.349999999999949907e+00 9.680651520545545674e-01
1.700000000000000122e-01 3.250000000000000000e+00 4.509999999999967812e+00 9.213734728758241621e-01
1.700000000000000122e-01 3.250000000000000000e+00 5.029999999999956728e+00 9.551596060604690130e-01
1.700000000000000122e-01 3.250000000000000000e+00 4.669999999999964402e+00 9.338163829966948937e-01
1.700000000000000122e-01 3.250000000000000000e+00 4.289999999999972502e+00 9.010026005382946179e-01
1.700000000000000122e-01 3.250000000000000000e+00 5.809999999999940101e+00 9.800077830489735131e-01
1.700000000000000122e-01 3.250000000000000000e+00 5.619999999999944151e+00 9.758158181280378596e-01
1.700000000000000122e-01 3.250000000000000000e+00 5.469999999999947349e+00 9.718063567658578039e-01
1.700000000000000122e-01 3.250000000000000000e+00 5.229999999999952465e+00 9.637712015889842165e-01
1.700000000000000122e-01 3.250000000000000000e+00 5.009999999999957154e+00 9.541851974308294126e-01
1.700000000000000122e-01 3.250000000000000000e+00 4.339999999999971436e+00 9.059528497591682328e-01
1.700000000000000122e-01 3.250000000000000000e+00 3.629999999999986571e+00 8.437949951933539916e-01
1.700000000000000122e-01 3.250000000000000000e+00 3.569999999999987850e+00 8.464192119933554581e-01
1.700000000000000122e-01 3.250000000000000000e+00 3.919999999999980389e+00 8.614643333650670032e-01
1.700000000000000122e-01 3.250000000000000000e+00 5.669999999999943086e+00 9.770074375532767919e-01
1.700000000000000122e-01 3.250000000000000000e+00 4.399999999999970157e+00 9.116514774100116236e-01
1.700000000000000122e-01 3.250000000000000000e+00 4.459999999999968878e+00 9.170727223175842990e-01
1.700000000000000122e-01 3.250000000000000000e+00 5.709999999999942233e+00 9.779134124426221986e-01
1.700000000000000122e-01 3.250000000000000000e+00 3.489999999999989555e+00 8.570506814504637028e-01
1.700000000000000122e-01 3.250000000000000000e+00 5.209999999999952891e+00 9.629961768561078328e-01
1.700000000000000122e-01 3.250000000000000000e+00 4.929999999999958860e+00 9.500590431911497546e-01
1.700000000000000122e-01 3.250000000000000000e+00 5.299999999999950973e+00 9.663476808676213503e-01
1.700000000000000122e-01 3.250000000000000000e+00 5.249999999999952038e+00 9.645286139451182406e-01
1.700000000000000122e-01 3.250000000000000000e+00 5.969999999999936691e+00 9.829088530967727833e-01
1.700000000000000122e-01 3.250000000000000000e+00 4.479999999999968452e+00 9.188168031649895928e-01
1.700000000000000122e-01 3.250000000000000000e+00 4.939999999999958646e+00 9.505954192953638415e-01
1.700000000000000122e-01 3.250000000000000000e+00 4.879999999999959925e+00 9.472850393653302614e-01
1.700000000000000122e-01 3.250000000000000000e+00 4.949999999999958433e+00 9.511257907595952465e-01
1.700000000000000122e-01 3.250000000000000000e+00 4.199999999999974420e+00 8.916823134695641695e-01
1.700000000000000122e-01 3.250000000000000000e+00 4.769999999999962270e+00 9.406127166457753930e-01
1.700000000000000122e-01 3.250000000000000000e+00 5.389999999999949054e+00 9.693698483643866659e-01
1.700000000000000122e-01 3.250000000000000000e+00 4.219999999999973994e+00 8.937942579749843519e-01
1.700000000000000122e-01 3.250000000000000000e+00 4.129999999999975913e+00 8.841475640826815807e-01
1.700000000000000122e-01 3.250000000000000000e+00 3.169999999999996376e+00 1.135844502904895803e+00
1.700000000000000122e-01 3.250000000000000000e+00 3.199999999999995737e+00 1.075467614992713816e+00
1.700000000000000122e-01 3.250000000000000000e+00 5.879999999999938609e+00 9.813405599486472175e-01
1.700000000000000122e-01 3.250000000000000000e+00 3.239999999999994884e+00 1.013010896781182391e+00
1.700000000000000122e-01 3.250000000000000000e+00 4.899999999999959499e+00 9.484133002539687496e-01
1.700000000000000122e-01 3.250000000000000000e+00 4.689999999999963975e+00 9.352339809669976134e-01
1.700000000000000122e-01 3.250000000000000000e+00 4.659999999999964615e+00 9.330963849980782321e-01
1.700000000000000122e-01 3.250000000000000000e+00 5.579999999999945004e+00 9.748126686042032363e-01
1.700000000000000122e-01 3.250000000000000000e+00 3.349999999999992539e+00 9.100466846674142296e-01
1.700000000000000122e-01 3.250000000000000000e+00 4.439999999999969305e+00 9.152970215606605064e-01
1.700000000000000122e-01 3.250000000000000000e+00 3.219999999999995310e+00 1.041992979232676753e+00
1.700000000000000122e-01 3.250000000000000000e+00 3.339999999999992752e+00 9.164430140918651269e-01
1.700000000000000122e-01 3.250000000000000000e+00 3.399999999999991473e+00 8.842401794668939274e-01
1.700000000000000122e-01 3.250000000000000000e+00 5.359999999999949694e+00 9.683969650177244315e-01
1.700000000000000122e-01 3.250000000000000000e+00 4.839999999999960778e+00 9.449517743926268976e-01
1.700000000000000122e-01 3.250000000000000000e+00 3.159999999999996589e+00 1.159166210186584056e+00
1.700000000000000122e-01 3.250000000000000000e+00 5.169999999999953744e+00 9.613916672414013487e-01
1.700000000000000122e-01 3.250000000000000000e+00 5.429999999999948201e+00 9.706160166468549289e-01
1.700000000000000122e-01 3.250000000000000000e+00 3.729999999999984439e+00 8.459037762191966570e-01
1.700000000000000122e-01 3.250000000000000000e+00 3.649999999999986144e+00 8.436663600276205210e-01
1.700000000000000122e-01 3.250000000000000000e+00 3.179999999999996163e+00 1.114210101708056788e+00
1.700000000000000122e-01 3.250000000000000000e+00 3.229999999999995097e+00 1.026983196429696266e+00
1.700000000000000122e-01 3.250000000000000000e+00 5.559999999999945430e+00 9.742937295246058005e-01
1.700000000000000122e-01 3.250000000000000000e+00 5.519999999999946283e+00 9.732197061983619557e-01
1.700000000000000122e-01 3.250000000000000000e+00 5.699999999999942446e+00 9.776907367094939127e-01
1.700000000000000122e-01 3.250000000000000000e+00 4.139999999999975699e+00 8.852351575881511891e-01
1.700000000000000122e-01 3.250000000000000000e+00 3.379999999999991900e+00 8.934294704304573953e-01
1.700000000000000122e-01 3.250000000000000000e+00 4.789999999999961844e+00 9.418865264191712550e-01
1.700000000000000122e-01 3.250000000000000000e+00 5.739999999999941593e+00 9.785665912171548353e-01
1.700000000000000122e-01 3.250000000000000000e+00 4.419999999999969731e+00 9.134898594773265268e-01
1.700000000000000122e-01 3.250000000000000000e+00 4.989999999999957581e+00 9.531884011189089012e-01
1.700000000000000122e-01 3.250000000000000000e+00 3.969999999999979323e+00 8.666937775343129813e-01
1.700000000000000122e-01 3.250000000000000000e+00 5.199999999999953104e+00 9.626019338340049414e-01
1.700000000000000122e-01 3.250000000000000000e+00 4.259999999999973141e+00 8.979505865352961358e-01
1.700000000000000122e-01 3.250000000000000000e+00 5.089999999999955449e+00 9.579530819057977542e-01
1.700000000000000122e-01 3.250000000000000000e+00 5.799999999999940314e+00 9.798087501189030046e-01
1.700000000000000122e-01 3.250000000000000000e+00 4.869999999999960139e+00 9.467114034916886967e-01
1.700000000000000122e-01 3.250000000000000000e+00 3.789999999999983160e+00 8.496999042813069281e-01
1.700000000000000122e-01 3.250000000000000000e+00 3.039999999999999147e+00 1.649559052280738625e+00
1.700000000000000122e-01 3.250000000000000000e+00 4.579999999999966320e+00 9.270622187794639313e-01
1.700000000000000122e-01 3.250000000000000000e+00 5.659999999999943299e+00 9.767744772539740383e-01
1.700000000000000122e-01 3.250000000000000000e+00 3.369999999999992113e+00 8.985667488418196402e-01
1.700000000000000122e-01 3.250000000000000000e+00 4.249999999999973355e+00 8.969204672676086565e-01
1.700000000000000122e-01 3.250000000000000000e+00 5.749999999999941380e+00 9.787794664610874884e-01
1.700000000000000122e-01 3.250000000000000000e+00 5.269999999999951612e+00 9.652688112093902317e-01
1.700000000000000122e-01 3.250000000000000000e+00 4.159999999999975273e+00 8.874004585813113355e-01
1.700000000000000122e-01 3.250000000000000000e+00 4.909999999999959286e+00 9.489680423645378005e-01
1.700000000000000122e-01 3.250000000000000000e+00 5.939999999999937330e+00 9.824033168303574204e-01
1.700000000000000122e-01 3.250000000000000000e+00 3.949999999999979750e+00 8.645746499991268097e-01
1.700000000000000122e-01 3.250000000000000000e+00 3.699999999999985079e+00 8.446159947403474311e-01
1.700000000000000122e-01 3.250000000000000000e+00 5.929999999999937543e+00 9.822310529650454258e-01
1.700000000000000122e-01 3.250000000000000000e+00 4.549999999999966960e+00 9.246714656995105308e-01
1.700000000000000122e-01 3.250000000000000000e+00 5.539999999999945857e+00 9.737628386512273693e-01
1.700000000000000122e-01 3.250000000000000000e+00 5.759999999999941167e+00 9.789899645509027026e-01
1.700000000000000122e-01 3.250000000000000000e+00 3.609999999999986997e+00 8.442681332113245452e-01
1.700000000000000122e-01 3.250000000000000000e+00 5.569999999999945217e+00 9.745546751819295084e-01
1.700000000000000122e-01 3.250000000000000000e+00 4.519999999999967599e+00 9.222098383744364858e-01
1.700000000000000122e-01 3.250000000000000000e+00 3.139999999999997016e+00 1.211498714263394394e+00
1.700000000000000122e-01 3.250000000000000000e+00 3.909999999999980602e+00 8.604499800320503100e-01
1.700000000000000122e-01 3.250000000000000000e+00 4.359999999999971010e+00 9.078824841948139879e-01
1.700000000000000122e-01 3.250000000000000000e+00 5.839999999999939462e+00 9.805917199867288936e-01
1.700000000000000122e-01 3.250000000000000000e+00 4.729999999999963123e+00 9.379808864367612520e-01
1.700000000000000122e-01 3.250000000000000000e+00 5.119999999999954809e+00 9.592796231165896526e-01
1.700000000000000122e-01 3.250000000000000000e+00 4.019999999999978257e+00 8.720978101030337770e-01
1.700000000000000122e-01 3.250000000000000000e+00 3.249999999999994671e+00 1.000000000000006439e+00
1.700000000000000122e-01 3.250000000000000000e+00 3.849999999999981881e+00 8.546843652509852340e-01
1.700000000000000122e-01 3.250000000000000000e+00 4.849999999999960565e+00 9.455448290955225099e-01
1.700000000000000122e-01 3.250000000000000000e+00 5.779999999999940741e+00 9.794039428969006922e-01
1.700000000000000122e-01 3.250000000000000000e+00 4.039999999999977831e+00 8.742853972576960508e-01
1.700000000000000122e-01 3.250000000000000000e+00 4.059999999999977405e+00 8.764796282170467245e-01
1.700000000000000122e-01 3.250000000000000000e+00 4.309999999999972076e+00 9.030038066109520312e-01
1.700000000000000122e-01 3.250000000000000000e+00 5.949999999999937117e+00 9.825736897991595997e-01
1.700000000000000122e-01 3.250000000000000000e+00 4.009999999999978471e+00 8.710081274435481635e-01
1.700000000000000122e-01 3.250000000000000000e+00 4.099999999999976552e+00 8.808695581908946304e-01
1.700000000000000122e-01 3.250000000000000000e+00 3.529999999999988702e+00 8.505145861607241731e-01
1.700000000000000122e-01 3.250000000000000000e+00 3.129999999999997229e+00 1.240868603501491529e+00
1.700000000000000122e-01 3.250000000000000000e+00 4.629999999999965254e+00 9.308910783729149596e-01
1.700000000000000122e-01 3.250000000000000000e+00 3.439999999999990621e+00 8.696293749782972871e-01
1.700000000000000122e-01 3.250000000000000000e+00 5.259999999999951825e+00 9.649008399019858295e-01
1.700000000000000122e-01 3.250000000000000000e+00 5.529999999999946070e+00 9.734928209901461127e-01
1.700000000000000122e-01 3.250000000000000000e+00 5.869999999999938822e+00 9.811564605023443963e-01
1.700000000000000122e-01 3.250000000000000000e+00 5.069999999999955875e+00 9.570430948134293070e-01
1.700000000000000122e-01 3.250000000000000000e+00 4.179999999999974847e+00 8.895503247468484753e-01
1.700000000000000122e-01 3.250000000000000000e+00 3.659999999999985931e+00 8.437194048436801319e-01
1.700000000000000122e-01 3.250000000000000000e+00 5.459999999999947562e+00 9.715138621877964509e-01
1.700000000000000122e-01 3.250000000000000000e+00 5.819999999999939888e+00 9.802046047270547291e-01
1.700000000000000122e-01 3.250000000000000000e+00 4.799999999999961631e+00 9.425130955762336393e-01
1.700000000000000122e-01 3.250000000000000000e+00 3.259999999999994458e+00 9.878811184381662835e-01
1.700000000000000122e-01 3.250000000000000000e+00 5.289999999999951186e+00 9.659921837659370958e-01
1.700000000000000122e-01 3.250000000000000000e+00 4.329999999999971649e+00 9.049770188175594310e-01
1.700000000000000122e-01 3.250000000000000000e+00 5.149999999999954170e+00 9.605613543143164401e-01
1.700000000000000122e-01 3.250000000000000000e+00 3.459999999999990195e+00 8.639273680719233850e-01
1.700000000000000122e-01 3.250000000000000000e+00 3.029999999999999361e+00 1.718357577191737873e+00
1.700000000000000122e-01 3.250000000000000000e+00 3.209999999999995524e+00 1.058123806033222092e+00
1.700000000000000122e-01 3.250000000000000000e+00 4.819999999999961204e+00 9.437458413458953421e-01
1.700000000000000122e-01 3.250000000000000000e+00 5.159999999999953957e+00 9.609788926715533419e-01
1.700000000000000122e-01 3.250000000000000000e+00 4.279999999999972715e+00 8.999918131556585710e-01
1.700000000000000122e-01 3.250000000000000000e+00 3.069999999999998508e+00 1.477134838207182943e+00
1.700000000000000122e-01 3.250000000000000000e+00 3.719999999999984652e+00 8.454226461116955971e-01
1.700000000000000122e-01 3.250000000000000000e+00 4.609999999999965681e+00 9.293827151518576635e-01
1.700000000000000122e-01 3.250000000000000000e+00 5.099999999999955236e+00 9.584003322483642950e-01
1.700000000000000122e-01 3.250000000000000000e+00 4.239999999999973568e+00 8.958842436811768062e-01
1.700000000000000122e-01 3.250000000000000000e+00 5.829999999999939675e+00 9.803992416482699701e-01
1.700000000000000122e-01 3.250000000000000000e+00 5.859999999999939035e+00 9.809703040270107977e-01
1.700000000000000122e-01 3.250000000000000000e+00 3.579999999999987637e+00 8.457161213625836726e-01
1.700000000000000122e-01 3.250000000000000000e+00 5.479999999999947136e+00 9.720955243884663588e-01
1.700000000000000122e-01 3.250000000000000000e+00 4.959999999999958220e+00 9.516502161969109252e-01
1.700000000000000122e-01 3.250000000000000000e+00 4.169999999999975060e+00 8.884774804375427104e-01
1.700000000000000122e-01 3.250000000000000000e+00 5.339999999999950120e+00 9.677295058502787262e-01
1.700000000000000122e-01 3.250000000000000000e+00 5.039999999999956515e+00 9.556385587716180741e-01
1.700000000000000122e-01 3.250000000000000000e+00 4.759999999999962483e+00 9.399653661242431957e-01
1.700000000000000122e-01 3.250000000000000000e+00 4.679999999999964189e+00 9.345289000252049449e-01
1.700000000000000122e-01 3.250000000000000000e+00 5.629999999999943938e+00 9.760595705431073243e-01
1.700000000000000122e-01 3.250000000000000000e+00 4.379999999999970584e+00 9.097822079538157025e-01
1.700000000000000122e-01 3.250000000000000000e+00 3.859999999999981668e+00 8.556003611757803107e-01
1.700000000000000122e-01 3.250000000000000000e+00 4.859999999999960352e+00 9.461313528000748763e-01
1.700000000000000122e-01 3.250000000000000000e+00 4.709999999999963549e+00 9.366220207133566511e-01
1.700000000000000122e-01 3.250000000000000000e+00 5.719999999999942020e+00 9.781335935693065142e-01
1.700000000000000122e-01 3.250000000000000000e+00 4.999999999999957367e+00 9.536896265996973598e-01
1.700000000000000122e-01 3.250000000000000000e+00 5.309999999999950759e+00 9.666991150214652162e-01
1.700000000000000122e-01 3.250000000000000000e+00 5.049999999999956302e+00 9.561120866237982074e-01
1.700000000000000122e-01 3.250000000000000000e+00 5.599999999999944578e+00 9.753199391776510296e-01
1.700000000000000122e-01 3.250000000000000000e+00 4.719999999999963336e+00 9.373050756099776670e-01
1.700000000000000122e-01 3.250000000000000000e+00 4.269999999999972928e+00 8.989744237403142213e-01
1.700000000000000122e-01 3.250000000000000000e+00 4.569999999999966533e+00 9.262731423587379220e-01
1.700000000000000122e-01 3.250000000000000000e+00 5.129999999999954596e+00 9.597117732568435367e-01
1.700000000000000122e-01 3.250000000000000000e+00 4.229999999999973781e+00 8.948421060931972537e-01
1.700000000000000122e-01 3.250000000000000000e+00 5.079999999999955662e+00 9.575006879767992141e-01
1.700000000000000122e-01 3.250000000000000000e+00 3.829999999999982307e+00 8.529184240206804102e-01
1.700000000000000122e-01 3.250000000000000000e+00 3.089999999999998082e+00 1.384977263690142735e+00
1.700000000000000122e-01 3.250000000000000000e+00 3.299999999999993605e+00 9.471355907049255896e-01
1.700000000000000122e-01 3.250000000000000000e+00 3.619999999999986784e+00 8.439860064585275046e-01
1.700000000000000122e-01 3.250000000000000000e+00 5.219999999999952678e+00 9.633859158669418887e-01
1.700000000000000122e-01 3.250000000000000000e+00 4.809999999999961418e+00 9.431328484580514537e-01
1.700000000000000122e-01 3.250000000000000000e+00 3.809999999999982734e+00 8.512519604355963665e-01
1.700000000000000122e-01 3.250000000000000000e+00 3.679999999999985505e+00 8.440386770759866764e-01
1.700000000000000122e-01 3.250000000000000000e+00 5.609999999999944365e+00 9.755692855480810888e-01
1.700000000000000122e-01 3.250000000000000000e+00 5.549999999999945643e+00 9.740297960203769811e-01
